Area_Name,Year,Education_Above_Primary_but_below_Matric_or_Higher_Secondary,Education_Illiterate,Education_Matric_or_Higher_Secondary_&_above,Education_Total,Education_Upto_primary,Economic_Set_up_Annual_Income_250001_to_50000,Economic_Set_up_Annual_Income_upto_Rs_25000,Economic_Set_up_Middle_income_from_100001_to_200000,Economic_Set_up_Middle_income_from_50001_to_100000,Economic_Set_up_Total,Economic_Set_up_Upper_income_above_Rs_300000,Economic_Set_up_Upper_middle_income_from_200001_to_300000,Family_back_ground_Homeless,Family_back_ground_Living_with_guardian,Family_back_ground_Living_with_parents,Family_back_ground_Total,Recidivism_New_Delinquent,Recidivism_Old_Delinquent,Recidivism_Total
Andaman & Nicobar Islands,2001,12,0,0,16,4,12,4,0,0,16,0,0,0,0,16,16,16,0,16
Andaman & Nicobar Islands,2002,4,0,0,6,2,5,1,0,0,6,0,0,0,0,6,6,6,0,6
Andaman & Nicobar Islands,2003,7,0,0,9,2,3,2,0,4,9,0,0,0,0,9,9,9,0,9
Andaman & Nicobar Islands,2004,6,0,0,13,7,1,12,0,0,13,0,0,0,5,8,13,13,0,13
Andaman & Nicobar Islands,2005,6,0,0,10,4,8,2,0,0,10,0,0,0,3,7,10,10,0,10
Andaman & Nicobar Islands,2006,45,0,3,91,43,73,15,3,0,91,0,0,0,6,85,91,88,3,91
Andaman & Nicobar Islands,2007,32,0,3,75,40,57,13,0,5,75,0,0,0,6,69,75,73,2,75
Andaman & Nicobar Islands,2008,36,0,12,55,7,16,0,8,31,55,0,0,0,5,50,55,51,4,55
Andaman & Nicobar Islands,2009,22,0,2,38,14,18,8,1,11,38,0,0,0,3,35,38,33,5,38
Andaman & Nicobar Islands,2010,5,1,1,26,19,7,17,0,2,26,0,0,0,9,17,26,23,3,26
Andhra Pradesh,2001,178,640,64,1565,683,104,1421,9,27,1565,4,0,552,287,726,1565,1392,173,1565
Andhra Pradesh,2002,291,1033,115,2084,645,521,1256,37,270,2084,0,0,703,374,1007,2084,1676,408,2084
Andhra Pradesh,2003,513,1193,150,2673,817,617,1774,5,277,2673,0,0,732,380,1561,2673,2376,297,2673
Andhra Pradesh,2004,440,959,149,2196,648,437,1620,8,131,2196,0,0,902,361,933,2196,1729,467,2196
Andhra Pradesh,2005,463,988,138,2428,839,611,1633,19,165,2428,0,0,980,402,1046,2428,2013,415,2428
Andhra Pradesh,2006,313,783,102,1879,681,382,1425,14,58,1879,0,0,438,284,1157,1879,1553,326,1879
Andhra Pradesh,2007,317,749,180,1953,707,297,1550,40,54,1953,9,3,367,251,1335,1953,1656,297,1953
Andhra Pradesh,2008,326,655,87,1622,554,215,1309,9,85,1622,0,4,272,229,1121,1622,1436,186,1622
Andhra Pradesh,2009,367,513,164,1565,521,263,1177,15,108,1565,0,2,116,258,1191,1565,1424,141,1565
Andhra Pradesh,2010,421,767,115,1949,646,423,1322,57,136,1949,3,8,172,235,1542,1949,1655,294,1949
Arunachal Pradesh,2001,39,16,12,137,70,38,99,0,0,137,0,0,0,58,79,137,130,7,137
Arunachal Pradesh,2002,32,41,10,132,49,66,30,10,26,132,0,0,1,18,113,132,132,0,132
Arunachal Pradesh,2003,52,69,0,196,75,63,69,0,64,196,0,0,0,98,98,196,173,23,196
Arunachal Pradesh,2004,23,21,21,91,26,56,35,0,0,91,0,0,0,23,68,91,89,2,91
Arunachal Pradesh,2005,109,4,0,147,34,54,23,20,50,147,0,0,0,78,69,147,122,25,147
Arunachal Pradesh,2006,41,0,0,80,39,43,9,0,28,80,0,0,0,33,47,80,80,0,80
Arunachal Pradesh,2007,39,20,0,105,46,56,40,0,9,105,0,0,0,55,50,105,105,0,105
Arunachal Pradesh,2008,43,14,0,85,28,31,50,0,4,85,0,0,0,16,69,85,85,0,85
Arunachal Pradesh,2009,67,14,8,139,50,88,22,0,29,139,0,0,0,72,67,139,139,0,139
Arunachal Pradesh,2010,32,0,35,81,14,48,13,0,20,81,0,0,0,54,27,81,81,0,81
Assam,2001,74,91,0,253,88,47,177,13,16,253,0,0,21,74,158,253,248,5,253
Assam,2002,120,100,18,332,94,46,199,27,40,332,2,18,34,103,195,332,296,36,332
Assam,2003,73,127,80,378,98,40,274,17,34,378,7,6,18,143,217,378,327,51,378
Assam,2004,106,76,41,331,108,101,153,23,35,331,2,17,25,48,258,331,235,96,331
Assam,2005,94,140,19,373,120,69,244,13,29,373,6,12,24,95,254,373,293,80,373
Assam,2006,123,211,54,539,151,191,289,2,57,539,0,0,47,220,272,539,489,50,539
Assam,2007,362,255,292,1155,246,76,1050,6,23,1155,0,0,270,371,514,1155,803,352,1155
Assam,2008,54,330,1,644,259,254,315,24,40,644,11,0,37,240,367,644,249,395,644
Assam,2009,210,109,77,563,167,148,376,10,29,563,0,0,87,187,289,563,518,45,563
Assam,2010,26,225,9,385,125,129,179,27,40,385,3,7,84,143,158,385,219,166,385
Bihar,2001,87,190,56,586,253,213,303,12,58,586,0,0,43,101,442,586,576,10,586
Bihar,2002,118,157,76,660,309,168,360,23,109,660,0,0,46,116,498,660,647,13,660
Bihar,2003,77,105,26,292,84,123,150,5,14,292,0,0,32,68,192,292,273,19,292
Bihar,2004,24,161,0,236,51,92,124,0,20,236,0,0,21,29,186,236,219,17,236
Bihar,2005,142,95,28,337,72,63,160,5,109,337,0,0,12,60,265,337,325,12,337
Bihar,2006,79,87,0,239,73,51,162,0,26,239,0,0,10,23,206,239,226,13,239
Bihar,2007,592,491,37,1469,349,404,879,12,174,1469,0,0,66,297,1106,1469,1394,75,1469
Bihar,2008,388,395,84,1244,377,448,597,63,124,1244,3,9,85,190,969,1244,1164,80,1244
Bihar,2009,328,307,71,1066,360,393,537,67,69,1066,0,0,121,223,722,1066,892,174,1066
Bihar,2010,263,241,50,742,188,259,397,17,64,742,2,3,117,149,476,742,611,131,742
Chandigarh,2001,33,12,0,71,26,40,29,0,2,71,0,0,0,4,67,71,71,0,71
Chandigarh,2002,46,6,5,75,18,14,31,2,28,75,0,0,0,0,75,75,75,0,75
Chandigarh,2003,72,24,6,116,14,41,23,4,48,116,0,0,3,0,113,116,116,0,116
Chandigarh,2004,46,42,2,109,19,35,20,4,48,109,0,2,16,31,62,109,109,0,109
Chandigarh,2005,17,54,4,116,41,34,82,0,0,116,0,0,0,0,116,116,116,0,116
Chandigarh,2006,34,36,7,107,30,21,70,4,12,107,0,0,6,3,98,107,102,5,107
Chandigarh,2007,58,15,20,118,25,51,33,15,17,118,0,2,2,4,112,118,118,0,118
Chandigarh,2008,75,38,13,162,36,79,46,1,34,162,0,2,4,3,155,162,152,10,162
Chandigarh,2009,46,23,32,135,34,4,82,16,33,135,0,0,4,2,129,135,122,13,135
Chandigarh,2010,48,24,33,168,63,29,87,11,41,168,0,0,0,8,160,168,161,7,168
Chhattisgarh,2001,348,205,61,1362,748,224,1071,19,43,1362,3,2,37,143,1182,1362,1210,152,1362
Chhattisgarh,2002,409,404,32,1407,562,304,958,30,88,1407,6,21,83,207,1117,1407,1208,199,1407
Chhattisgarh,2003,423,416,23,1602,740,323,1174,37,62,1602,1,5,128,112,1362,1602,1533,69,1602
Chhattisgarh,2004,699,432,91,2002,780,319,1474,118,85,2002,0,6,27,267,1708,2002,1771,231,2002
Chhattisgarh,2005,589,888,153,3137,1507,505,2500,20,102,3137,0,10,20,536,2581,3137,2765,372,3137
Chhattisgarh,2006,724,326,251,2053,752,409,1432,27,170,2053,0,15,78,389,1586,2053,1891,162,2053
Chhattisgarh,2007,553,346,286,2027,842,314,1249,157,157,2027,67,83,150,350,1527,2027,1811,216,2027
Chhattisgarh,2008,743,1341,235,3046,727,671,1555,88,672,3046,0,60,18,210,2818,3046,2279,767,3046
Chhattisgarh,2009,1063,842,287,3112,920,887,1500,140,509,3112,0,76,191,481,2440,3112,2425,687,3112
Chhattisgarh,2010,739,442,102,2356,1073,550,1663,17,126,2356,0,0,33,430,1893,2356,2026,330,2356
Dadra & Nagar Haveli,2001,0,0,0,2,2,0,2,0,0,2,0,0,0,0,2,2,2,0,2
Dadra & Nagar Haveli,2002,0,0,0,0,0,0,0,0,0,0,0,0,0,0,0,0,0,0,0
Dadra & Nagar Haveli,2003,1,0,0,2,1,0,2,0,0,2,0,0,0,0,2,2,2,0,2
Dadra & Nagar Haveli,2004,2,0,0,4,2,0,4,0,0,4,0,0,0,0,4,4,4,0,4
Dadra & Nagar Haveli,2005,4,3,0,19,12,0,19,0,0,19,0,0,0,0,19,19,19,0,19
Dadra & Nagar Haveli,2006,4,1,0,9,4,0,9,0,0,9,0,0,0,0,9,9,8,1,9
Dadra & Nagar Haveli,2007,2,0,0,11,9,9,2,0,0,11,0,0,0,0,11,11,0,11,11
Dadra & Nagar Haveli,2008,6,2,8,22,6,8,14,0,0,22,0,0,0,0,22,22,22,0,22
Dadra & Nagar Haveli,2009,4,8,8,26,6,12,6,2,6,26,0,0,0,0,26,26,9,17,26
Dadra & Nagar Haveli,2010,8,2,0,19,9,8,7,0,4,19,0,0,0,0,19,19,19,0,19
Daman & Diu,2001,0,2,0,2,0,0,2,0,0,2,0,0,2,0,0,2,2,0,2
Daman & Diu,2002,0,0,0,0,0,0,0,0,0,0,0,0,0,0,0,0,0,0,0
Daman & Diu,2003,2,0,0,2,0,0,0,0,2,2,0,0,0,0,2,2,2,0,2
Daman & Diu,2004,0,0,0,0,0,0,0,0,0,0,0,0,0,0,0,0,0,0,0
Daman & Diu,2005,1,0,0,1,0,0,0,0,1,1,0,0,0,0,1,1,1,0,1
Daman & Diu,2006,4,1,0,5,0,0,1,0,4,5,0,0,0,1,4,5,5,0,5
Daman & Diu,2007,0,3,11,14,0,11,3,0,0,14,0,0,0,3,11,14,8,6,14
Daman & Diu,2008,8,3,0,11,0,0,11,0,0,11,0,0,0,2,9,11,11,0,11
Daman & Diu,2009,0,0,1,3,2,2,0,0,1,3,0,0,0,1,2,3,3,0,3
Daman & Diu,2010,3,4,1,10,2,2,3,2,2,10,0,1,2,4,4,10,10,0,10
Delhi,2001,228,268,39,858,323,129,686,0,40,858,3,0,88,84,686,858,835,23,858
Delhi,2002,310,397,168,1192,317,214,868,6,99,1192,4,1,132,136,924,1192,1146,46,1192
Delhi,2003,200,380,25,802,197,119,659,6,18,802,0,0,64,60,678,802,737,65,802
Delhi,2004,298,341,42,909,228,244,556,17,92,909,0,0,63,409,437,909,830,79,909
Delhi,2005,394,458,67,1250,331,240,938,17,53,1250,1,1,100,278,872,1250,1208,42,1250
Delhi,2006,188,739,36,1513,550,353,1125,0,35,1513,0,0,77,416,1020,1513,1111,402,1513
Delhi,2007,170,490,40,970,270,210,689,14,53,970,0,4,114,145,711,970,811,159,970
Delhi,2008,74,222,37,523,190,158,310,7,41,523,2,5,46,57,420,523,465,58,523
Delhi,2009,167,199,60,586,160,114,425,0,47,586,0,0,26,76,484,586,518,68,586
Delhi,2010,204,154,34,627,235,122,408,18,70,627,3,6,36,87,504,627,580,47,627
Goa,2001,34,31,9,93,19,28,62,1,1,93,1,0,1,6,86,93,93,0,93
Goa,2002,11,25,8,68,24,7,60,0,1,68,0,0,3,5,60,68,67,1,68
Goa,2003,27,34,7,87,19,5,75,1,6,87,0,0,1,1,85,87,77,10,87
Goa,2004,33,19,4,74,18,14,50,1,9,74,0,0,3,2,69,74,68,6,74
Goa,2005,12,32,8,66,14,6,51,4,5,66,0,0,4,1,61,66,64,2,66
Goa,2006,20,30,3,68,15,5,60,1,1,68,1,0,1,1,66,68,67,1,68
Goa,2007,23,20,5,77,29,20,50,0,5,77,1,1,5,8,64,77,77,0,77
Goa,2008,27,11,10,67,19,20,29,0,17,67,0,1,2,2,63,67,67,0,67
Goa,2009,30,22,5,76,19,14,52,2,8,76,0,0,1,6,69,76,75,1,76
Goa,2010,37,19,6,77,15,22,39,4,9,77,0,3,0,2,75,77,74,3,77
Gujarat,2001,1144,835,266,4370,2125,711,3332,9,306,4370,5,7,918,182,3270,4370,4082,288,4370
Gujarat,2002,843,750,130,3335,1612,292,2824,29,180,3335,2,8,157,237,2941,3335,3109,226,3335
Gujarat,2003,572,613,157,2717,1375,484,2163,10,57,2717,1,2,163,251,2303,2717,2313,404,2717
Gujarat,2004,489,970,159,2689,1071,238,2392,19,33,2689,1,6,157,270,2262,2689,2363,326,2689
Gujarat,2005,596,640,214,2748,1298,330,2192,49,169,2748,4,4,241,244,2263,2748,2404,344,2748
Gujarat,2006,669,677,145,2807,1316,314,2363,10,74,2807,38,8,215,224,2368,2807,2405,402,2807
Gujarat,2007,726,520,284,2878,1348,416,2333,3,124,2878,0,2,261,260,2357,2878,2528,350,2878
Gujarat,2008,678,453,172,2699,1396,405,2113,10,140,2699,0,31,155,245,2299,2699,2220,479,2699
Gujarat,2009,758,386,168,2466,1154,333,1960,14,146,2466,5,8,155,262,2049,2466,1989,477,2466
Gujarat,2010,662,341,176,2121,942,379,1642,17,75,2121,2,6,164,281,1676,2121,1763,358,2121
Haryana,2001,879,343,232,2015,561,502,1086,86,339,2015,0,2,35,84,1896,2015,1955,60,2015
Haryana,2002,1104,424,331,2511,652,577,1518,80,336,2511,0,0,84,216,2211,2511,2421,90,2511
Haryana,2003,997,245,310,2026,474,493,1178,84,202,2026,0,69,97,189,1740,2026,2012,14,2026
Haryana,2004,923,233,127,1677,394,516,848,81,186,1677,0,46,17,82,1578,1677,1665,12,1677
Haryana,2005,798,234,173,1623,418,546,886,52,139,1623,0,0,45,65,1513,1623,1601,22,1623
Haryana,2006,851,264,147,1712,450,619,850,47,196,1712,0,0,32,64,1616,1712,1711,1,1712
Haryana,2007,945,214,166,1840,515,778,849,50,161,1840,2,0,46,104,1690,1840,1828,12,1840
Haryana,2008,882,154,244,1799,519,804,718,43,218,1799,7,9,223,113,1463,1799,1774,25,1799
Haryana,2009,579,137,203,1374,455,587,491,36,236,1374,9,15,223,50,1101,1374,1328,46,1374
Haryana,2010,443,79,139,907,246,326,305,31,223,907,8,14,149,18,740,907,863,44,907
Himachal Pradesh,2001,69,1,41,142,31,32,84,0,26,142,0,0,0,5,137,142,116,26,142
Himachal Pradesh,2002,50,14,20,121,37,70,47,0,4,121,0,0,0,44,77,121,120,1,121
Himachal Pradesh,2003,63,6,30,124,25,32,49,1,42,124,0,0,0,22,102,124,109,15,124
Himachal Pradesh,2004,57,0,38,117,22,41,72,0,4,117,0,0,0,2,115,117,117,0,117
Himachal Pradesh,2005,103,5,38,194,48,95,89,0,10,194,0,0,0,2,192,194,194,0,194
Himachal Pradesh,2006,67,2,47,128,12,27,90,6,5,128,0,0,0,6,122,128,128,0,128
Himachal Pradesh,2007,75,5,57,145,8,53,73,2,17,145,0,0,0,0,145,145,145,0,145
Himachal Pradesh,2008,77,11,45,163,30,35,85,11,32,163,0,0,0,8,155,163,163,0,163
Himachal Pradesh,2009,72,1,56,170,41,59,85,0,26,170,0,0,0,0,170,170,170,0,170
Himachal Pradesh,2010,92,6,92,218,28,78,113,6,6,218,12,3,0,4,214,218,218,0,218
Jammu & Kashmir,2001,1,1,0,2,0,1,1,0,0,2,0,0,0,0,2,2,2,0,2
Jammu & Kashmir,2002,0,3,0,3,0,0,3,0,0,3,0,0,0,0,3,3,3,0,3
Jammu & Kashmir,2003,17,0,0,18,1,2,15,0,1,18,0,0,0,0,18,18,18,0,18
Jammu & Kashmir,2004,2,3,0,11,6,1,9,0,0,11,1,0,1,0,10,11,11,0,11
Jammu & Kashmir,2005,1,2,0,7,4,0,7,0,0,7,0,0,0,0,7,7,7,0,7
Jammu & Kashmir,2006,5,0,3,8,0,0,0,3,2,8,1,2,0,0,8,8,8,0,8
Jammu & Kashmir,2007,3,3,7,15,2,5,5,0,5,15,0,0,0,0,15,15,15,0,15
Jammu & Kashmir,2008,4,3,0,12,5,12,0,0,0,12,0,0,0,0,12,12,12,0,12
Jammu & Kashmir,2009,2,0,5,11,4,7,4,0,0,11,0,0,0,0,11,11,11,0,11
Jammu & Kashmir,2010,15,2,3,27,7,10,9,2,6,27,0,0,0,1,26,27,27,0,27
Jharkhand,2001,43,126,15,298,114,35,248,3,11,298,0,1,80,58,160,298,213,85,298
Jharkhand,2002,13,194,160,746,379,188,356,73,89,746,20,20,157,174,415,746,510,236,746
Jharkhand,2003,175,250,186,821,210,287,305,94,135,821,0,0,0,446,375,821,375,446,821
Jharkhand,2004,176,248,186,822,212,290,302,98,132,822,0,0,0,442,380,822,381,441,822
Jharkhand,2005,236,307,246,1060,271,349,361,158,192,1060,0,0,26,548,486,1060,499,561,1060
Jharkhand,2006,207,384,41,862,230,272,565,0,25,862,0,0,211,221,430,862,722,140,862
Jharkhand,2007,109,161,54,509,185,36,466,0,7,509,0,0,71,132,306,509,430,79,509
Jharkhand,2008,57,335,7,549,150,138,401,0,10,549,0,0,30,125,394,549,522,27,549
Jharkhand,2009,102,343,36,788,307,173,546,5,64,788,0,0,124,201,463,788,549,239,788
Jharkhand,2010,10,47,5,104,42,61,33,0,10,104,0,0,3,5,96,104,98,6,104
Karnataka,2001,91,566,19,843,167,42,736,11,51,843,0,3,39,111,693,843,786,57,843
Karnataka,2002,64,116,5,277,92,47,215,1,13,277,0,1,12,35,230,277,258,19,277
Karnataka,2003,104,80,52,358,122,72,263,0,23,358,0,0,79,82,197,358,349,9,358
Karnataka,2004,96,172,25,440,147,39,353,8,40,440,0,0,16,94,330,440,439,1,440
Karnataka,2005,44,96,7,242,95,47,188,0,6,242,1,0,19,12,211,242,235,7,242
Karnataka,2006,417,77,62,659,103,61,558,4,26,659,0,10,26,51,582,659,600,59,659
Karnataka,2007,419,50,60,617,88,97,446,23,46,617,0,5,24,81,512,617,571,46,617
Karnataka,2008,95,162,77,515,181,120,323,16,47,515,3,6,4,79,432,515,360,155,515
Karnataka,2009,88,54,58,282,82,60,158,21,40,282,2,1,10,27,245,282,251,31,282
Karnataka,2010,35,63,37,204,69,50,139,0,13,204,0,2,8,27,169,204,194,10,204
Kerala,2001,59,23,7,132,43,1,127,0,4,132,0,0,16,28,88,132,132,0,132
Kerala,2002,115,7,59,234,53,41,188,0,5,234,0,0,21,39,174,234,230,4,234
Kerala,2003,288,33,363,764,80,467,248,1,48,764,0,0,21,92,651,764,749,15,764
Kerala,2004,193,20,71,382,98,96,264,4,18,382,0,0,19,71,292,382,366,16,382
Kerala,2005,247,24,62,464,131,133,296,3,32,464,0,0,26,41,397,464,462,2,464
Kerala,2006,193,32,81,444,138,69,338,7,29,444,0,1,11,26,407,444,436,8,444
Kerala,2007,318,14,184,675,159,233,289,41,112,675,0,0,20,44,611,675,643,32,675
Kerala,2008,373,13,214,776,176,233,373,23,147,776,0,0,2,47,727,776,760,16,776
Kerala,2009,345,13,214,707,135,208,340,31,118,707,0,10,33,35,639,707,682,25,707
Kerala,2010,348,38,262,826,178,245,422,36,115,826,0,8,7,55,764,826,794,32,826
Lakshadweep,2001,0,0,1,1,0,0,1,0,0,1,0,0,0,0,1,1,1,0,1
Lakshadweep,2002,0,0,0,0,0,0,0,0,0,0,0,0,0,0,0,0,0,0,0
Lakshadweep,2003,0,0,0,0,0,0,0,0,0,0,0,0,0,0,0,0,0,0,0
Lakshadweep,2004,0,0,0,0,0,0,0,0,0,0,0,0,0,0,0,0,0,0,0
Lakshadweep,2005,0,0,0,1,1,0,1,0,0,1,0,0,0,0,1,1,1,0,1
Lakshadweep,2006,0,0,0,0,0,0,0,0,0,0,0,0,0,0,0,0,0,0,0
Lakshadweep,2007,0,0,0,0,0,0,0,0,0,0,0,0,0,0,0,0,0,0,0
Lakshadweep,2008,0,0,0,0,0,0,0,0,0,0,0,0,0,0,0,0,0,0,0
Lakshadweep,2009,0,0,0,0,0,0,0,0,0,0,0,0,0,0,0,0,0,0,0
Lakshadweep,2010,0,0,0,0,0,0,0,0,0,0,0,0,0,0,0,0,0,0,0
Madhya Pradesh,2001,1330,1757,560,7328,3681,1797,2451,293,2625,7328,61,101,116,1527,5685,7328,3816,3512,7328
Madhya Pradesh,2002,2684,3488,282,8536,2082,956,6916,148,516,8536,0,0,156,2330,6050,8536,6657,1879,8536
Madhya Pradesh,2003,1282,1909,430,7672,4051,1682,5137,72,766,7672,0,15,219,947,6506,7672,7167,505,7672
Madhya Pradesh,2004,1668,2160,491,7433,3114,1576,4885,76,891,7433,0,5,402,970,6061,7433,6974,459,7433
Madhya Pradesh,2005,2003,1553,416,6378,2406,1346,4136,181,611,6378,22,82,232,844,5302,6378,5673,705,6378
Madhya Pradesh,2006,1955,1770,556,6814,2533,1745,4353,182,523,6814,10,1,400,1663,4751,6814,6401,413,6814
Madhya Pradesh,2007,2231,1752,749,7350,2618,1595,4755,343,650,7350,0,7,389,1364,5597,7350,6711,639,7350
Madhya Pradesh,2008,1977,1735,608,7108,2788,1326,4516,301,960,7108,0,5,305,1233,5570,7108,6367,741,7108
Madhya Pradesh,2009,1910,1310,925,6186,2041,1271,4112,316,484,6186,1,2,331,1238,4617,6186,5404,782,6186
Madhya Pradesh,2010,1941,1696,516,6449,2296,1685,4002,172,578,6449,1,11,204,919,5326,6449,4849,1600,6449
Maharashtra,2001,1973,832,168,4990,2017,314,4626,4,46,4990,0,0,168,503,4319,4990,4778,212,4990
Maharashtra,2002,2133,759,302,5379,2185,930,4256,32,159,5379,0,2,162,587,4630,5379,5063,316,5379
Maharashtra,2003,1520,919,363,5070,2268,481,4328,80,160,5070,7,14,116,834,4120,5070,4674,396,5070
Maharashtra,2004,2291,859,362,5496,1984,968,4248,59,220,5496,0,1,134,665,4697,5496,5285,211,5496
Maharashtra,2005,2270,1153,375,6303,2505,993,4951,105,247,6303,4,3,385,664,5254,6303,6065,238,6303
Maharashtra,2006,2143,1028,364,6658,3123,735,5486,145,274,6658,3,15,302,849,5507,6658,6396,262,6658
Maharashtra,2007,2045,1236,492,6836,3063,1334,4945,231,304,6836,11,11,174,870,5792,6836,6420,416,6836
Maharashtra,2008,2375,1551,523,7019,2570,1620,4524,99,654,7019,7,115,373,994,5652,7019,6706,313,7019
Maharashtra,2009,2544,768,892,6972,2768,1204,4713,267,645,6972,15,128,438,864,5670,6972,6432,540,6972
Maharashtra,2010,2224,810,862,6388,2492,1254,4186,213,603,6388,13,119,429,793,5166,6388,6120,268,6388
Manipur,2001,0,0,0,0,0,0,0,0,0,0,0,0,0,0,0,0,0,0,0
Manipur,2002,0,0,0,0,0,0,0,0,0,0,0,0,0,0,0,0,0,0,0
Manipur,2003,0,0,0,0,0,0,0,0,0,0,0,0,0,0,0,0,0,0,0
Manipur,2004,0,0,0,0,0,0,0,0,0,0,0,0,0,0,0,0,0,0,0
Manipur,2005,0,0,0,0,0,0,0,0,0,0,0,0,0,0,0,0,0,0,0
Manipur,2006,0,0,0,0,0,0,0,0,0,0,0,0,0,0,0,0,0,0,0
Manipur,2007,0,0,0,0,0,0,0,0,0,0,0,0,0,0,0,0,0,0,0
Manipur,2008,0,0,0,0,0,0,0,0,0,0,0,0,0,0,0,0,0,0,0
Manipur,2009,0,0,0,0,0,0,0,0,0,0,0,0,0,0,0,0,0,0,0
Manipur,2010,0,0,0,0,0,0,0,0,0,0,0,0,0,0,0,0,0,0,0
Meghalaya,2001,3,39,1,66,23,7,56,0,3,66,0,0,2,25,39,66,59,7,66
Meghalaya,2002,8,33,0,68,27,3,65,0,0,68,0,0,0,30,38,68,62,6,68
Meghalaya,2003,8,15,0,35,12,4,31,0,0,35,0,0,2,11,22,35,29,6,35
Meghalaya,2004,18,14,3,55,20,19,36,0,0,55,0,0,0,9,46,55,52,3,55
Meghalaya,2005,12,50,1,107,44,18,62,12,15,107,0,0,1,21,85,107,89,18,107
Meghalaya,2006,11,23,2,58,22,2,51,0,5,58,0,0,13,19,26,58,58,0,58
Meghalaya,2007,6,55,5,106,40,9,97,0,0,106,0,0,1,35,70,106,87,19,106
Meghalaya,2008,55,28,2,139,54,41,87,2,8,139,0,1,13,37,89,139,134,5,139
Meghalaya,2009,27,14,1,88,46,38,45,0,5,88,0,0,7,13,68,88,85,3,88
Meghalaya,2010,24,43,3,118,48,22,77,1,18,118,0,0,0,49,69,118,106,12,118
Mizoram,2001,20,6,0,49,23,6,41,0,2,49,0,0,2,14,33,49,39,10,49
Mizoram,2002,20,4,0,60,36,10,39,0,11,60,0,0,0,19,41,60,42,18,60
Mizoram,2003,34,3,10,82,35,17,61,1,3,82,0,0,0,4,78,82,78,4,82
Mizoram,2004,206,349,110,818,153,115,703,0,0,818,0,0,115,201,502,818,689,129,818
Mizoram,2005,104,50,21,413,238,127,132,49,78,413,3,24,0,56,357,413,251,162,413
Mizoram,2006,18,5,0,89,66,5,55,20,9,89,0,0,0,21,68,89,65,24,89
Mizoram,2007,59,0,0,91,32,35,56,0,0,91,0,0,0,0,91,91,52,39,91
Mizoram,2008,47,0,5,70,18,7,63,0,0,70,0,0,0,8,62,70,68,2,70
Mizoram,2009,8,0,10,20,2,3,17,0,0,20,0,0,0,0,20,20,20,0,20
Mizoram,2010,73,3,0,116,40,90,25,0,1,116,0,0,0,2,114,116,106,10,116
Nagaland,2001,12,1,1,26,12,0,26,0,0,26,0,0,2,3,21,26,12,14,26
Nagaland,2002,12,0,0,14,2,2,12,0,0,14,0,0,0,5,9,14,12,2,14
Nagaland,2003,1,0,0,1,0,0,1,0,0,1,0,0,0,0,1,1,1,0,1
Nagaland,2004,0,0,0,3,3,0,3,0,0,3,0,0,0,0,3,3,3,0,3
Nagaland,2005,0,0,0,3,3,0,3,0,0,3,0,0,0,0,3,3,3,0,3
Nagaland,2006,0,1,0,3,2,0,3,0,0,3,0,0,0,1,2,3,3,0,3
Nagaland,2007,0,0,0,0,0,0,0,0,0,0,0,0,0,0,0,0,0,0,0
Nagaland,2008,0,0,0,0,0,0,0,0,0,0,0,0,0,0,0,0,0,0,0
Nagaland,2009,12,2,0,20,6,0,2,3,14,20,0,1,12,6,2,20,20,0,20
Nagaland,2010,30,3,8,53,12,9,44,0,0,53,0,0,0,11,42,53,53,0,53
Odisha,2001,51,39,12,212,110,23,188,0,1,212,0,0,7,41,164,212,208,4,212
Odisha,2002,43,63,17,192,69,39,151,0,2,192,0,0,4,30,158,192,189,3,192
Odisha,2003,77,143,15,313,78,26,286,0,1,313,0,0,13,65,235,313,310,3,313
Odisha,2004,64,162,8,359,125,24,335,0,0,359,0,0,19,37,303,359,355,4,359
Odisha,2005,178,251,18,655,208,42,603,4,6,655,0,0,75,79,501,655,549,106,655
Odisha,2006,172,244,26,627,185,59,552,1,15,627,0,0,0,78,549,627,622,5,627
Odisha,2007,229,148,64,658,217,164,446,0,48,658,0,0,66,157,435,658,654,4,658
Odisha,2008,207,257,40,773,269,174,577,0,22,773,0,0,17,83,673,773,668,105,773
Odisha,2009,213,83,39,483,148,76,357,6,39,483,0,5,15,48,420,483,471,12,483
Odisha,2010,164,195,40,544,145,66,447,2,29,544,0,0,28,73,443,544,536,8,544
Puducherry,2001,0,0,0,3,3,0,3,0,0,3,0,0,0,0,3,3,3,0,3
Puducherry,2002,5,2,0,16,9,3,13,0,0,16,0,0,0,0,16,16,16,0,16
Puducherry,2003,4,2,0,40,34,5,35,0,0,40,0,0,4,3,33,40,40,0,40
Puducherry,2004,0,0,0,55,55,0,55,0,0,55,0,0,43,0,12,55,55,0,55
Puducherry,2005,25,0,0,42,17,16,23,0,3,42,0,0,0,0,42,42,42,0,42
Puducherry,2006,0,6,0,37,31,20,14,0,3,37,0,0,0,0,37,37,37,0,37
Puducherry,2007,0,5,0,62,57,37,17,0,8,62,0,0,0,3,59,62,62,0,62
Puducherry,2008,13,0,4,55,38,18,33,0,4,55,0,0,0,0,55,55,54,1,55
Puducherry,2009,0,27,0,81,54,46,33,0,2,81,0,0,0,3,78,81,79,2,81
Puducherry,2010,0,0,0,49,49,7,42,0,0,49,0,0,0,3,46,49,49,0,49
Punjab,2001,4,10,7,29,8,5,15,3,6,29,0,0,0,0,29,29,20,9,29
Punjab,2002,73,30,9,156,44,31,67,3,54,156,0,1,24,10,122,156,155,1,156
Punjab,2003,10,83,19,132,20,20,105,3,4,132,0,0,0,1,131,132,83,49,132
Punjab,2004,14,52,11,96,19,27,58,2,9,96,0,0,0,2,94,96,96,0,96
Punjab,2005,33,50,11,135,41,69,55,2,8,135,0,1,1,0,134,135,135,0,135
Punjab,2006,30,45,18,159,66,92,59,0,1,159,7,0,0,0,159,159,159,0,159
Punjab,2007,29,44,15,129,41,63,63,0,0,129,3,0,0,0,129,129,129,0,129
Punjab,2008,29,26,29,113,29,38,51,14,10,113,0,0,0,0,113,113,113,0,113
Punjab,2009,57,62,47,233,67,103,122,0,8,233,0,0,0,3,230,233,225,8,233
Punjab,2010,53,81,29,246,83,81,151,0,14,246,0,0,2,21,223,246,241,5,246
Rajasthan,2001,910,957,194,3245,1184,666,2202,64,301,3245,0,12,36,217,2992,3245,3087,158,3245
Rajasthan,2002,617,242,40,1937,1038,298,1527,36,65,1937,0,11,30,188,1719,1937,1852,85,1937
Rajasthan,2003,700,277,52,1862,833,339,1322,28,155,1862,0,18,91,100,1671,1862,1699,163,1862
Rajasthan,2004,746,346,61,1875,722,368,1303,26,162,1875,1,15,12,166,1697,1875,1798,77,1875
Rajasthan,2005,608,517,66,1958,767,339,1413,32,171,1958,0,3,33,256,1669,1958,1867,91,1958
Rajasthan,2006,637,350,83,2086,1016,539,1253,15,279,2086,0,0,22,101,1963,2086,2029,57,2086
Rajasthan,2007,699,539,143,2124,743,579,1269,76,182,2124,0,18,25,200,1899,2124,2015,109,2124
Rajasthan,2008,754,532,129,2352,937,533,1335,68,386,2352,2,28,39,195,2118,2352,2268,84,2352
Rajasthan,2009,818,503,229,2456,906,545,1509,138,233,2456,0,31,21,196,2239,2456,2354,102,2456
Rajasthan,2010,960,322,279,2378,817,683,1290,90,279,2378,9,27,43,165,2170,2378,2174,204,2378
Sikkim,2001,12,0,0,17,5,0,17,0,0,17,0,0,0,5,12,17,17,0,17
Sikkim,2002,0,1,0,2,1,0,2,0,0,2,0,0,0,1,1,2,2,0,2
Sikkim,2003,0,0,0,17,17,0,17,0,0,17,0,0,0,0,17,17,17,0,17
Sikkim,2004,7,0,0,13,6,6,3,0,4,13,0,0,0,0,13,13,13,0,13
Sikkim,2005,9,0,0,24,15,0,24,0,0,24,0,0,0,0,24,24,24,0,24
Sikkim,2006,9,4,0,35,22,4,31,0,0,35,0,0,0,0,35,35,35,0,35
Sikkim,2007,8,38,0,94,48,0,94,0,0,94,0,0,0,0,94,94,94,0,94
Sikkim,2008,4,7,0,37,26,4,31,0,2,37,0,0,0,2,35,37,36,1,37
Sikkim,2009,18,12,0,60,30,14,43,0,3,60,0,0,7,10,43,60,60,0,60
Sikkim,2010,43,4,2,82,33,0,82,0,0,82,0,0,2,10,70,82,78,4,82
Tamil Nadu,2001,163,855,21,4555,3516,211,4144,29,144,4555,5,22,334,473,3748,4555,4444,111,4555
Tamil Nadu,2002,183,3004,2,6082,2893,886,5177,3,12,6082,2,2,376,777,4929,6082,5763,319,6082
Tamil Nadu,2003,248,2605,278,4895,1764,178,4712,1,3,4895,0,1,350,783,3762,4895,4804,91,4895
Tamil Nadu,2004,145,1553,30,2373,645,72,2296,0,5,2373,0,0,288,662,1423,2373,2223,150,2373
Tamil Nadu,2005,319,979,39,2148,811,161,1985,1,1,2148,0,0,470,209,1469,2148,2009,139,2148
Tamil Nadu,2006,327,755,12,1974,880,138,1825,0,11,1974,0,0,294,208,1472,1974,1795,179,1974
Tamil Nadu,2007,394,639,8,1721,680,179,1448,0,94,1721,0,0,289,247,1185,1721,1661,60,1721
Tamil Nadu,2008,238,653,28,1593,674,172,1384,0,37,1593,0,0,163,219,1211,1593,1532,61,1593
Tamil Nadu,2009,370,1727,52,2921,772,448,2418,0,55,2921,0,0,338,225,2358,2921,2658,263,2921
Tamil Nadu,2010,455,445,48,1644,696,223,1374,3,44,1644,0,0,116,302,1226,1644,1522,122,1644
Tripura,2001,2,10,2,20,6,6,12,1,1,20,0,0,14,2,4,20,8,12,20
Tripura,2002,2,5,0,7,0,2,5,0,0,7,0,0,2,1,4,7,7,0,7
Tripura,2003,0,0,0,0,0,0,0,0,0,0,0,0,0,0,0,0,0,0,0
Tripura,2004,0,0,0,0,0,0,0,0,0,0,0,0,0,0,0,0,0,0,0
Tripura,2005,0,0,0,0,0,0,0,0,0,0,0,0,0,0,0,0,0,0,0
Tripura,2006,0,0,0,0,0,0,0,0,0,0,0,0,0,0,0,0,0,0,0
Tripura,2007,0,1,0,2,1,2,0,0,0,2,0,0,0,2,0,2,2,0,2
Tripura,2008,7,21,7,43,8,12,21,2,8,43,0,0,15,14,14,43,43,0,43
Tripura,2009,9,22,0,91,60,22,47,0,22,91,0,0,12,33,46,91,91,0,91
Tripura,2010,5,35,0,46,6,11,32,0,3,46,0,0,0,0,46,46,46,0,46
Uttar Pradesh,2001,103,35,33,256,85,93,122,12,29,256,0,0,20,32,204,256,256,0,256
Uttar Pradesh,2002,32,15,17,96,32,14,79,0,3,96,0,0,8,7,81,96,96,0,96
Uttar Pradesh,2003,19,19,11,61,12,8,43,0,10,61,0,0,2,5,54,61,60,1,61
Uttar Pradesh,2004,29,60,7,135,39,24,91,5,12,135,0,3,13,47,75,135,125,10,135
Uttar Pradesh,2005,36,34,11,115,34,44,57,0,14,115,0,0,3,15,97,115,115,0,115
Uttar Pradesh,2006,53,41,15,172,63,58,83,6,25,172,0,0,0,13,159,172,172,0,172
Uttar Pradesh,2007,102,56,98,427,171,127,209,22,69,427,0,0,0,46,381,427,424,3,427
Uttar Pradesh,2008,133,45,40,347,129,127,115,24,80,347,0,1,2,40,305,347,347,0,347
Uttar Pradesh,2009,146,113,40,475,176,211,136,32,89,475,0,7,0,23,452,475,475,0,475
Uttar Pradesh,2010,308,166,100,852,278,251,269,109,197,852,4,22,13,98,741,852,852,0,852
Uttarakhand,2001,28,0,29,57,0,33,24,0,0,57,0,0,0,0,57,57,57,0,57
Uttarakhand,2002,6,0,27,34,1,19,12,0,3,34,0,0,0,1,33,34,34,0,34
Uttarakhand,2003,7,0,23,30,0,15,4,0,11,30,0,0,0,0,30,30,30,0,30
Uttarakhand,2004,19,0,12,36,5,25,5,0,6,36,0,0,0,0,36,36,36,0,36
Uttarakhand,2005,31,0,4,39,4,8,24,0,7,39,0,0,0,4,35,39,37,2,39
Uttarakhand,2006,37,25,11,106,33,34,57,2,13,106,0,0,0,4,102,106,75,31,106
Uttarakhand,2007,34,6,57,129,32,12,103,0,14,129,0,0,0,29,100,129,124,5,129
Uttarakhand,2008,30,49,33,157,45,33,98,1,25,157,0,0,0,0,157,157,157,0,157
Uttarakhand,2009,32,130,30,254,62,62,146,14,30,254,0,2,44,32,178,254,249,5,254
Uttarakhand,2010,31,51,1,154,71,63,21,24,30,154,0,16,42,2,110,154,154,0,154
West Bengal,2001,7,7,0,27,13,5,22,0,0,27,0,0,0,8,19,27,27,0,27
West Bengal,2002,2,6,0,17,9,3,14,0,0,17,0,0,1,2,14,17,17,0,17
West Bengal,2003,8,68,0,123,47,35,88,0,0,123,0,0,21,32,70,123,123,0,123
West Bengal,2004,28,21,0,93,44,15,78,0,0,93,0,0,27,27,39,93,89,4,93
West Bengal,2005,24,53,0,138,61,2,136,0,0,138,0,0,22,51,65,138,133,5,138
West Bengal,2006,29,28,8,124,59,32,85,0,7,124,0,0,14,33,77,124,123,1,124
West Bengal,2007,41,51,5,145,48,37,105,2,1,145,0,0,14,35,96,145,140,5,145
West Bengal,2008,257,23,128,707,299,273,369,12,47,707,2,4,43,456,208,707,648,59,707
West Bengal,2009,47,37,27,195,84,37,107,6,42,195,1,2,36,79,80,195,173,22,195
West Bengal,2010,153,30,35,337,119,117,140,1,78,337,0,1,18,122,197,337,327,10,337
